1111111111111111111111111
1000000000000000000000001
1000000000010000000000001
100000000000000P000000001
100000C000000000000000001
10000000000000000000C0001
1000000000000000000000001
1000000000000C00000000001
1E00000000000000000000001
1111111111111111111111111