1111111111111111111111111
10000000000N0000000000001
100N0000000100C0C00000001
10000000000000CPC00000001
100000C000000000000000001
10000000000000000000C0001
1000E00000000000000000001
100N00000000NC00000000001
1000000000000000000000001
1111111111111111111111111
