1111111111111111111111111
10000100000N0C0000000NC01
111N000000010N1110000N001
100000000000001PC00000001
10000000000000000111N0001
10000001111110000000C0001
1000E00000000000000000001
100NC0000000NC00000110001
10000000000000000001C0001
1111111111111111111111111