111111111111111111111111111111111111111
100000000000100000100000000000000100001
1PCCCCC00001000000000100000000000000001
1E0000000100000000001100000000000100001
111111111111111111111111111111111111111