1111111111111111111111111
1000000000000000000000001
10000000000100CCC00000001
10000000000000CPC00000001
100000C0000000CCC00000001
10000000000000000000C0001
1000E00000000000000000001
1000000000000C00000000001
1000000000000000000000001
1111111111111111111111111